   WE                            textures/unis/blue.png
NO textures/unis/black.png     



SO textures/unis/green.png

F   50, 50, 100

EA textures/unis/red.png 




C 35, 98, 52

111111111111111111111111
100000000000000000000001
10DW00000000000000000001
100000000000000000000001
100000000000000000000001
100000000000000000000001
100000000000000000000001
100000111110000101010001
100000100010000000000001
100000D00010000100010001
100000100010000000000001
10000011D100001010100001
100000000000000100000001
100D00000000000000000001
100000000000000000000001
100000000000000000000001
100000000000000000000001
100000000000000000000001
100000000000000000000001
111111D11000000000000001
100100001000000000000001
100000101000000000000001
10010000D000000000000001
100111111000000000000001
100000000000000000000001
100000000000000000000001
111111111111111111111111
