NO textures/bricks/bricks.png
SO textures/bricks/bricks0.png
WE textures/bricks/bricks2.png
EA textures/bricks/bricks3.png
F   50, 50, 100





C 35, 98, 52

111111111111111111111111
100000000000000000000001
100000000000000000000001
100000000000000000000001
100000000000000000000001
100000000000000000000001
100000000000000000000001
100000111110000101010001
100000100010000000000001
100000000010000100010001
100000100010000000000001
100000110100001010100001
100000000000000100000001
100000000000000000000001
100000000000000000000001
100000000000000000000001
100000000000000000000001
100000000000000000000001
100000000000000000000001
111111011000000000000001
100100001000000000000001
100000101000000000000001
1001000N0000000000000001
100111111000000000000001
100000000000000000000001
100000000000000000000001
111111111111111111111111
