NO textures/bricks.png
SO textures/bricks0.png
WE textures/bricks3.png
EA textures/bricks2.png

F 0,0,0
C 100, 100,0


1111111111111111111111111
1000000000110000010000001
10110000011100000D000W001
1001000000000000010000001
1001000000000000000000001
1111111111111111111111111

