NO textures/wolfenstein/grey_stone.xpm
SO textures/wolfenstein/purple_stone.xpm
WE textures/wolfenstein/red_brick.xpm
EA textures/wolfenstein/wood.xpm

F 18,53,25
C 153,204,255

111111111111111111111111111111111111111111111111111111111111111
100100100100100100110011001100110011001100110011001100110011001
100100100100100100110011001100110011001100110011001100110011001
100100100100100100110011001100110011001100110011001100110011001
100100100000100100110011001100110011001100110011001100110011001
100000000S00000000100010001000100010001000100010001000100010001
100001111111100000100010001000100010001000100010001000100010001
111100000000000111111111111111111111111111111111111111111111111
100000010101000000100010001000100010001000100010001000100010001
111100000000000111111111111111111111111111111111111111111111111
100000010101000000100010001000100010001000100010001000100010001
111100000000000111111111111111111111111111111111111111111111111
100000010101000000100010001000100010001000100010001000100010001
111100000000000111111111111111111111111111111111111111111111111
100000010101000000100010001000100010001000100010001000100010001
111100000000000111111111111111111111111111111111111111111111111
100000010101000000100010001000100010001000100010001000100010001
111100000000000111111111111111111111111111111111111111111111111
100000010101000000100010001000100010001000100010001000100010001
111100000000000111111111111111111111111111111111111111111111111
100000010101000000100010001000100010001000100010001000100010001
111111111111111111111111111111111111111111111111111111111111111
