NO textures/bricks/bricks.png
SO textures/bricks/bricks0.png
WE textures/bricks/bricks3.png
EA textures/bricks/bricks2.png

F 150, 75, 0
C 133, 133, 133

111111111111111111111111111111111111
100000000000000000000000000000000001
10000000000000D0000000DDDDD000000001
1000000000000DD000000D00000D00000001
100000000000D0D000000000000D00000001
10000000000D00D000000000000D00000001
1000000000D000D000000000000D00000001
100000000D0000D00000000000D000000001
10000000D00000D0000000000D0000000001
1000000D000000D000000000D00000000001
1000000DDDDDDDDD0000000D000000000001
10000000000000D0000000D0000000000001
10000000000000D000000D00000000000001
10000000000000D0N0000D00000000000001
10000000000000D000000DDDDDDD00000001
100000000000000000000000000000000001
111111111111111111111111111111111111
