NO textures/bricks/bricks.png
SO textures/bricks/bricks0.png
WE textures/bricks/bricks2.png
EA textures/bricks/bricks3.png

F 164,169,20
C 153,204,254


111111111111111111111
101000001000000000001
10101010101D111110001
100010100010000010001
11D110101111101011101
100000101000101000001
10111D101011101111111
101000001010100000101
1010111110101D1110101
101010001010100010101
101110101010101010101
100000101010001010001
111D11101011D11011101
100000101000100010001
101110101D10101110111
10D000100000100010101
10101111D111111010101
1000D0000000000010001
101010111000W00111101
101000001000000000001
111111111111111111111
