NO textures/bricks/bricks.png
SO textures/bricks/bricks0.png
WE textures/bricks/bricks2.png
EA textures/bricks/bricks3.png

F 118, 53, 25  




C  35, 98, 150

11111111111111111
10000000000000001
100D0000D0000D001
10000000000000001
10000000000000001
10000000000000001
10000000000000001
10000000000000001
10000000000000001
10000000000000001
10000000000000001
10000000000000001
10000000000000001
10000000000000001
10000000000000001
10000000000000001
10000000000000001
10000000000000001
10000000000000001
10000000000000001
10000000000000001
10000000000000001
10000000000000001
10000000000000001
10000000N00000001
11111111111111111
