NO textures/bricks/bricks.png
SO textures/bricks/bricks0.png
WE textures/bricks/bricks3.png
EA textures/bricks/bricks2.png

F 255, 255,0
C 255, 0,0


        1111111111111111111111111
        1000000000110000000000001
        1011000001110000000000001
        100D000000000000000000001
111111111011000001110000000000001
1000000000DD00000111011D110111111
111101D11111D1011100000010001
1111D1D11111D1011101010000001
110000001101010111000000D0001
10000000000000000000000000001
1000000000000000D101010010001
11000001110101011111011110N0111
11110111 1110101 101111010001
11111111 1111111 111111111111